33 9
######################                   
#                    #              
#                    #              
#         1          #              
#                                 
#        #######                  
#       ###    ##                 
# P    ####    ###   |            
########################    ####  