33 9
######################                   
#                    #              
#                    #              
#                    #              
#        1                        
#        #######                  
#   1   ###    ##                 
# P    ####    ###   |            
########################    ####  